MMMMGGGGGGGGGGGRRGGGGGGGG
MMMGGGGGGGGGGGRRGGGGGGGGG
MMMGGGGGGGGGGRRGGGGGGGGGG
MMGGGGGGGGGGGRRGGGGGGGGMM
MMGGGGGGGGGGGRRGGGGGMMMMM
MGGGGGGGGGGGRRGGGGGMMMMMG
GGGGGGGGGGGGRRGGGGGMMMMGG
RRRRRRRRRRGGRRGGGGGMMMMGG
RRRRRRRRRRGGGRRGGGGGMMMGG
GGGGGGGGGGGGGGRRGGGGGGGGG
GGGGGGGGGGGGGGRRGGGGGGGGG
GGGGGGGGGGGGGGGRRGGGGGGGG
GGGGGGGGGGGGGGGRRGGGGGGGG
GGGGGGGGGGGGGGGGRRGGGGGGG