MMMMGGGGGGGGGGGRRGGGG
MMMGGGGGGGGGGGRRGGGGG
MMMGGGGGGGGGGRRGGGGGG
MMGGGGGGGGGGGRRGGGGGG
MMGGGGGGGGGGGRRGGGGGM
MGGGGGGGGGGGRRGGGGGMM
GGGGGGGGGGGGRRGGGGGMM
RRRRRRRRRRGGRRGGGGGMM
RRRRRRRRRRGGGRRGGGGGM
GGGGGGGGGGGGGGRRGGGGG
